                                                                     +------------+            
                                    +-------------------+            |............|            
                                    |...................##############............|            
                                    |...................|            |...+----+...|            
                                    |...................|            |...|    |...|            
                                    |...................##############...|    |...|            
                                    +#---#--------------+            |...|    |...|            
                                     #   #                           |...|    |...|            
                                     #   #               +-------+   |...|    |...|            
                                     #   #               |.......|   |...|    |...|            
                                     #   ################|.......#####...+----+...|            
                                     #   #               |.......|   |............|            
                                     #   #               +---#---+   |............|            
                                     #   #                   #       +------#-----+            
                                     #   #                   #              #                  
                                     #   #                +--#--+           #                  
                                     #   ##################.....|           #                  
                                     #    #               |.....|    ###############           
                                     #    #               +-----+    #      #      #           
                                     #   +#----------------------+   #  +---#---+  #           
                                     #   |.......................|   #  |.......|  #           
                                     #   |.......................|   #  |.......|  #           
                                     #   |.......................#####  |.......|  #           
                                     #   |.......................|  #   |.......|  #           
                                     #   |.......................|  #   +-------+  #           
                                     #   +-#-------+.............|  #              #           
                                     #     #       |.............|  #              #           
                                     #     #       |.............|  #              #           
                                     #     #       |.............|  #              #           
                                     #     #       +-------------+  #              #           
                                     #     #                        #              #           
                                     #     #                    +---#--------------#---+       
                                     #     #                    |......................|       
                                     #     #                    |......+-------+.......|       
                                     ############################......|       |.......|       
                                                                |......|       |.......|       
                                                                |......+-------+.......|       
                                                                +----------------------+       
